
Southern Lamellar Armor = desert_lamellar
Southern Scale Armor = desert_scale_armor
Stitched Leather Over Mail = stitched_leather_over_mail
Sturgia Cavalry Armor = sturgia_cavalry_armor
Southern Lamellar Armor = southern_lamellar_armor
Guarded Padded Vambrace = guarded_padded_vambrace
Southern Moccasins = southern_moccasins
Wrapped Shoes = wrapped_shoes
Highland Thinhide Coif = Item id="thinhide_coif
Highland Wrapped Headcloth = wrapped_headcloth
Highland Leather Studded Helm = leather_studdedhelm
Highland Hood = battania_civil_hood
Wolf Head = wolfhead
Highland Fur Helme = battania_fur_helmet
Bear Head = bearhead
Leather Studdedhelm Over Thinhide = leather_studdedhelm_over_thinhide
Leather Studdedhelm Over Headcloth = leather_studdedhelm_over_headcloth
Roughscale Helmet = roughscale_helmet
Ridged Highland helm = ridged_northernhelm
Leather Studdedhelm Over Roughscale = leather_studdedhelm_over_roughscale
Highland Crowned Helmet = battanian_crowned_helmet
Highland Noble Helmet with Feather = battanian_noble_helmet_with_feather
Highland Plated Noble Helmet = battanian_plated_noble_helmet
Highland Shoulder Straps = battania_shoulder_strap
Highland Cloak with Shoulder Straps = battania_shoulder_strap_cloak
Highland Cloak = battania_cloak
Wolf Shoulder = wolf_shoulder
Battania Woodland Cloak = battania_woodland_cloak
Bear Pelt = bearskin
Highland Furred Cloak = battania_cloak_furr
Highland Warlord Pauldrons = battania_warlord_pauldrons
Highland Cloak = battania_civil_cloak
Highland Shoulder Fur = battania_shoulder_furr
Highland Furred Cloak = battania_cloak_furr
Leopard Pelt = leopard_pelt
Rough Bearskin = rough_bearskin
Highland Cape = battania_civil_cape
Baggy Trunks = baggy_trunks
Armored Baggy Trunks = armored_baggy_trunks
Sleeveless Studded Fur Armor = sleeveless_studded_fur_armor
Studded Fur Armor = studded_fur_armor
Tattered Rags = tattered_rags
Burlap Waistcoat = burlap_waistcoat
Woodland Garments = battania_woodland_outfit
Highland Peasant Dress = battania_dress_a
Highland Dress = battania_dress_b
Highland Plaid Dress = battania_dress_c
Highland Tunic = battania_civil_a
Highland Villager Tunic = battania_civil_b
Highland Dress = battania_female_civil_a
Highland Villager Dress = battania_female_civil_b
Fur Armor With Strap = fur_armor_with_strap
Fur Armor = fur_armor
Long Fur Coat = long_fur_coat
Highland Cloth = highland_cloth
Battanian Savage Armor = battanian_savage_armor
Armored Bearskin = armored_bearskin
Highland Scale Mail = western_scale_mail
Kilt Over Plated Leather = kilt_over_plated_leather
Woodland Chainmail = battania_woodland_chainmail
Ranger Mail = ranger_mail
Highland Mercenary Armor = battania_mercenary_armor
Highland Scale Armor = scale_armor
Highland Noble Armor = battania_noble_armor
Highland Warlord Armor = battania_warlord_armor
Ragged Armwraps = ragged_armwraps
Armwraps = armwraps
Guarded Armwraps = guarded_armwraps
Rough Tied Bracers = rough_tied_bracers
Buttoned Leather Bracers = buttoned_leather_bracers
Strapped Leather Bracers = strapped_leather_bracers
Roughtied Leather Bracers = roughtied_leather_bracers
Highland Noble Bracers = battania_noble_bracers
Highland Gloves = highland_gloves
Highland Warlord Bracers = battania_warlord_bracers
Highland Leg Wrappings = highland_leg_wrappings
Rough Tied Boots = rough_tied_boots
Highland Leather Boots = battania_leather_boots
Woodland Boots = battania_woodland_boots
Highland Fur Boots = battania_fur_boots
Ragged Boots = ragged_boots
Highland Boots = highland_boots
Wrapped Leather Boots = wrapped_leather_boots
Belted Leather Boots = belted_leather_boots
Turndown Leather Boots = turndown_leather_boots
Highland Warlord Boots = battania_warlord_boots
Upturned Fur Cap = upturned_fur_cap
Eastern Fur Hood = fur_hood
Peaked Fur Hood = peaked_fur_hood
Nomad Cap = nomad_cap
Decorated Nomad Cap = decorated_nomad_cap
Eastern Cap = eastern_cap
Eastern Fur Hat = fur_hat
Nomad Padded Hood = nomad_padded_hood
Plumed Fur Lined Helmet = plumed_fur_lined_helmet
Nomad Helme = nomad_helmet
Plumed Nomad Helmet = plumed_nomad_helmet
Eastern Helmet = steppe_helmet
Plumed Lamellar Helmet = plumed_lamellar_helmet
Spiked Helmet With Facemask = spiked_helmet_with_facemask
Spiked Helmet = spiked_helmet
Eastern Vendel Helmet = eastern_vendel_helmet
Eastern Noble Helmet with Feathers = khuzait_noble_helmet_with_feathers
Eastern Noble Helmet with Fur = khuzait_noble_helmet_with_fur
Eastern Noble Helmet with Neckguard = khuzait_noble_helmet_with_neckguard
Bolted Leather Strips = bolted_leather_strips
Eastern Leather Shoulders = steppe_leather_shoulders
Reinforced Suede Shoulders = reinforced_suede_shoulders
Eastern Studded Shoulders = eastern_studded_shoulders
Eastern Leather Pauldrons = khuzait_leather_pauldron
Lamellar Shoulders = lamellar_shoulders
Brass Lamellar Shoulders = brass_lamellar_shoulder
Northern Lamellar Shoulders = brass_lamellar_shoulder_white
Eastern Steppe Armor = steppe_armor
Eastern Steppe Robe = steppe_robe
Studded Leather Waistcoat = studded_leather_waistcoat
Common Eastern Dress = khuzait_dress
Eastern Dress with Fur = khuzait_dress_b
Eastern Envelope Dress = steppe_dress
Eastern Rich Coat = khuzait_civil_coat
Eastern Thick Coat = khuzait_civil_coat_b
Reinforced Suede Armor = reinforced_suede_armor
Studded Steppe Leather = studded_steppe_leather
Belted Leather Cuirass = belted_leather_cuirass
Crude Eastern Leather Armor = crude_leather_armor
Eastern Leather With Belt = khuzait_belt_leather
Eastern Reinforced Armor = khuzait_fortified_armor
Eastern Mirrored Leather Armor = khuzait_sturdy_armor
Eastern Stitched Leather Coat = eastern_stitched_leather_coat
Eastern Leather Lamellar Armor = leather_lamellar_armor
Studded Leather Over Aketon = studded_leather_over_aketon
Eastern Lamellar Armor = eastern_lamellar_armor
Eastern Strapped Lamellar Armor = khuzait_lamellar_strapped
Eastern Plated Leather Vest = eastern_plated_leather_vest
Eastern Brass Lamellar Over Mail = brass_lamellar_over_mail
Eastern Plated Leather = eastern_plated_leather
Eastern Wrapped Armguards = eastern_wrapped_armguards
Eastern Leather Vambraces = steppe_leather_vambraces
Studded Leather Vambraces = studded_leather_vambraces
Studded Vambraces = studded_vambraces
Eastern Plated Leather Vambraces = eastern_plated_leather_vambraces
Eastern Leather Boots = eastern_leather_boots
Eastern Curved Boots = khuzait_curved_boots
Woven Leather Boots = woven_leather_boots
Eastern Steppe Leather Boots = steppe_leather_boots
Reinforced Suede Boots = reinforced_suede_boots
Eastern Leather Boots = leather_boots
Padded Coif = arming_cap
Padded Half Coif = padded_coif
Laced Coif = laced_coif
Cloth Headwrap = cloth_headwrap
Padded Cap = padded_cap
Leather Coif = arming_coif
Open Padded Coif = open_padded_coif
Western Scarf = head_piece
Western Head Wrap = head_wrapped
Western Loose Head Scarf = headscarf
Western Head Scarf = headscarf_c
Western Head Wrap = womens_headwrap_c
Western Head Wrapping = head_wrapping
Arming Cap = arming_cap
Cervelliere Over Arming Coif = cervelliere_over_arming_coif
Kettle Helmet With Leather = kettle_helmet_with_leather
Kettle Helmet Over Padded Coif = kettle_helmet_over_padded_coif
Kettle Helmet Over Laced Coif = kettle_helmet_over_laced_coif
Kettle Helmet Over Padded Cap = kettle_helmet_over_padded_cap
Kettle Helmet Over Padded Cloth = kettle_helmet_over_padded_cloth
Kettle Hat Over Padded Coif = kettle_hat_over_padded_coif
Guards Kettle Over Padded Coif = guards_kettle_over_padded_coif
Guard's Kettle Over Laced Coif = guards_kettle_over_laced_coif
Nasal Helmet Over Padded Coif = nasal_helmet_over_padded_coif
Nasal Helmet Over Laced Coif = nasal_helmet_over_laced_coif
Nasal Helmet Over Cloth Headwrap = nasal_helmet_over_cloth_headwrap
Nasal Helmet Over Padded Cloth = nasal_helmet_over_padded_cloth
Segmented Skullcap Over Padded Coif = segmented_skullcap_over_padded_coif
Segmented Skullcap Over Laced Coif = segmented_skullcap_over_laced_coif
Segmented Skullcap Over Padded Cloth = segmented_skullcap_over_padded_cloth
Peaked Helmet Over Laced Coif = peaked_helmet_over_laced_coif
Peaked Helmet Over Padded Cloth = peaked_helmet_over_padded_cloth
Segmented Cervelliere Over Padded Cloth = segmented_cervelliere_over_padded_cloth
Cervelliere Over Cloth Headwrap = cervelliere_over_cloth_headwrap
Cervelliere Over Laced Coif = cervelliere_over_laced_coif
Cervelliere Over Padded Cap = cervelliere_over_padded_cap
Nasal Cervelliere Over Padded Coif = nasal_cervelliere_over_padded_coif
Nasal Cervelliere Over Laced Coif = nasal_cervelliere_over_laced_coif
Nasal Cervelliere Over Padded Cap = nasal_cervelliere_over_padded_cap
Padded Leather Cape = padded_leather_cape
Kettle Helmet Over Arming Coif = kettle_helmet_over_arming_coif
Peaked Helmet Over Mail Coif = peaked_helmet_over_mail_coif
Nasal Cervelliere Over Mail Coif = nasal_cervelliere_over_mail_coif
Guard's Kettle Over Mail Coif = guards_kettle_over_mail_coif
Full Helm Over Arming Coif = full_helm_over_arming_coif
Visored Helmet Over Padded Cloth = visored_helmet_over_padded_cloth
Visored Helmet Over Padded Coif = visored_helmet_over_padded_coif
Segmented Cevelliere Over Laced Coif = segmented_cervelliere_over_laced_coif
Kettle Hat Over Padded Cloth = kettle_hat_over_padded_cloth
Kettle Hat Over Mail Coif = kettle_hat_over_mail_coif
Visored Helmet Over Mail Coif = visored_helmet_over_mail_coif
Visored Helmet Over Laced Coif = visored_helmet_over_laced_coif
Nasal Helmet Over Mail Coif = nasal_helmet_over_mail_coif
Full Helm Over Mail Coif = full_helm_over_mail_coif
Full Helm Over Laced Coif = full_helm_over_laced_coif
Full Helm Over Cloth Headwrap = full_helm_over_cloth_headwrap
Full Helm Over Padded Cap = full_helm_over_padded_cap
Full Helm Over Padded Cloth = full_helm_over_padded_cloth
Segmented Cevelliere Over Mail Coif = segmented_cervelliere_over_mail_coif
Kettle Helmet Over Mail = kettle_helmet_over_mail
Nasal Helmet Over Mail = nasal_helmet_over_mail
Segmented Skullcap Over Mail Coif = segmented_skullcap_over_mail_coif
Peaked Helmet Over Mail = peaked_helmet_over_mail
Segmented Cevelliere Over Mail = segmented_cervelliere_over_mail
Western Crowned Helmet = western_crowned_helmet
Plated Helmet with Sideguards = western_plated_helmet
Plated Helmet = vlandia_lord_helmet_b2
Western Crowned Plated Helmet = western_crowned_plated_helmet
Kettle Helmet With Mail = kettle_helmet_with_mail
Green Hood = green_hood
Leather Lamellar Shoulders = leather_lamellar_shoulders
Western Hood = hood
Padded Leather Shoulders = padded_leather_shoulders
Sackcloth Tunic = sackcloth_tunic
Western Cloth Tunic = cloth_tunic
Long Hemp Tunic = long_hemp_tunic
Long Woolen Tunic = long_woolen_tunic
Western Noble Dress = vlandian_noble_woman_dress
Western Common Dress = vlandian_woman_dress
Western Corseted Dress = vlandian_corset_dress
Scholars Robe = monk_robe
Padded Leather Shirt = padded_leather_shirt
Western Padded Coat = padded_coat
Leather Coat Over Cloth = leather_coat_over_cloth
Western Gambeson = gambeson_b
Western Aketon = aketon
Western Leather Coat = leather_coat
Sleeveless Padded Short Coat = sleeveless_padded_short_coat
Sleeveless Padded Coat = sleeveless_padded_coat
Padded Short Coat = padded_short_coat
Leather Scale Armor = leather_scale_armor
Woven Leather Vest = woven_leather_vest
Western Chainmail = vlandia_chainmail
Western Hauberk = hauberk
White Tabard Over Mail = white_coat_over_mail
Red Tabard Over Mail = red_coat_over_mail
Veteran Mercenary Armor = veteran_mercenary_armor
Western Mail Shirt = mail_shirt
Plated Leather Coat = plated_leather_coat
Coat of Plates Over Mail = coat_of_plates_over_mail
Banded Leather Over Mail = banded_leather_over_mail
Leather Gloves = leather_gloves
Padded Vambrace = padded_vambrace
Mail Mitten = mail_mitten
Reinforced Mail Mitten = reinforced_mail_mitten
Heavy Mail Mittens = lordly_mail_mitten
Reinforced Leather Vambraces = reinforced_leather_vambraces
Strapped Shoes = strapped_shoes
Leather Cavalier Boots = leather_cavalier_boots
Mail Cavalier Boots = mail_cavalier_boots
Northern Style Head Wrap = womens_headwrap_b
Northern Leather Cap = nordic_leather_cap
Northern Cap = nordic_fur_cap
Northern Fur Cap = northern_fur_cap
Northern Roughhide Cap = roughhide_cap
Northern Helmet Over Leather = goggled_helmet_over_leather
Northern Nasalhelm Over Leather = nasalhelm_over_leather
Sturgia Heavy Cavalry Helmet = sturgia_heavy_cavalary_helmet
Northern Nasal Helmet = nasal_helmet
Spangenhelm With Leather = spangenhelm_with_leather
Nasal Helmet With Leather = nasal_helmet_with_leather
Nasal Helmet With Mail = nasal_helmet_with_mail
Spangenhelm With Padded Cloth = spangenhelm_with_padded_cloth
Northern Visored Helmet = imperial_goggled_helmet
Northern Visored Cap = nordic_helmet
Northern Decorated Visored Helmet = decorated_goggled_helmet
Northern Closed Helmet = closed_goggled_helmet
Northern Closed Helmet Over Mail = goggled_helmet_over_full_mail
Northern Warlord Helmet Over Full Mail = lendman_helmet_over_full_mail
Northern Warlord Helmet = northern_warlord_helmet
Northern Lord Helmet = sturgian_lord_helmet_a
Northern Lord Helmet With Open Mail Coif = sturgian_lord_helmet_b
Pointed Northern Lord Helmet With Feather = sturgian_lord_helmet_c
Nasalhelm Over Mail = nasalhelm_over_mail
Goggled Helmet Over Mail = goggled_helmet_over_mail
Northern Warlord Helmet Over Mail = lendman_helmet_over_mail
Northern Goggled Helmet = northern_goggled_helmet
Northern Helmet Closed = sturgian_helmet_closed
Northern Open Helmet = sturgian_helmet_open
Northern Helmet = sturgian_helmet_base
Northern Open Helmet = sturgian_helmet_b_open
Northern Closed Helmet = sturgian_helmet_b_close
Stitched Leather Shoulders = stitched_leather_shoulders
Scarf = scarf
Woman's Hood = female_hood
Woman's Scarf = female_scarf
Mail Shoulders = mail_shoulders
Brass Scale Shoulders = brass_scale_shoulders
Northern Tunic = northern_tunic
Northern Luxery Tunic = nordic_tunic
Northern Belted Tunic = tundra_tunic
Roughcloth Shortcoat = roughcloth_shortcoat
Northern Dress = northern_dress
Laced Dress = laced_dress
Cut Dress = cut_dress
Cut Dress With Pouch = cut_dress_with_pouch
Dress = dress_with_overall
Plain Dress = plain_dress
Heavy Northern Tunic = heavy_nordic_tunic
Northern Sloven Leather = nordic_sloven_leather
Northern Heavy Coat = heavy_nordic_coat
Northern Padded Gambeson = northern_padded_gambeson
Northern Padded Cloth = northern_padded_cloth
Northern Layered Cloth = nordic_padded_cloth
Northern Leather Vest = northern_leather_vest
Stitched Leather Vest = stitched_leather_vest
Northern Leather Over Heavy Cloth = nordic_sloven
Layered Leather Tunic = layered_leather_tunic
Northern Leather Tabard = northern_leather_tabard
Northern Lamellar Armor = northern_lamellar_armor
Decorated Northern Hauberk = decorated_nordic_hauberk
Northern Leather Tabard Over Mail = nordic_sloven_over_mail
Northern Hauberk = nordic_hauberk
Leather and Iron Plate Armor = leather_and_iron_plate_armor
Northern Coat Of Plates = northern_coat_of_plates
Northern Lamellar Armor = nordic_lamellar_armor
Northern Lamellar Vest = nordic_lamellar_vest
Sturgian fortified armor = sturgian_fortified_armor
Northern Lamellar Over Mail = northern_brass_lamellar_over_mail
Sturgian lamellar base = sturgian_lamellar_base
Sturgian lamellar fortified = sturgian_lamellar_fortified
Northern Plated Gloves = northern_plated_gloves
Northern Brass Bracers = northern_brass_bracers
Mail Chausses = mail_chausses
Strapped Mail Chausses = strapped_mail_chausses
Northern Plated Boots = northern_plated_boots
Imperial Padded Coif = imperial_padded_coif
Laced Cloth Coif = laced_cloth_coif
Imperial Leather Coif = imperial_leather_coif
Imperial Cloth Coif = imperial_cloth_coif
Leather Cap = leather_cap
Pilgrim's Hood = pilgrim_hood
Tall Helmet = tall_helmet
Imperial Mail Coif = imperial_mail_coif
Imperial Nasal Helm = imperial_nasal_helm
Bronze Nasalhelm Over Imperial Leather = leatherlame_nasalhelm_over_imperial_leather
Bronze Feathered Spangenhelm Over Leather = leatherlame_feathered_spangenhelm_over_leather
Bronze Roundkettle = leatherlame_roundkettle
Roundkettle Over Imperial Padding = roundkettle_over_imperial_padding
Roundkettle Over Laced Cloth = roundkettle_over_laced_cloth
Roundkettle Over Imperial Leather = roundkettle_over_imperial_leather
Bronze Roundkettle Over Imperial Leather = leatherlame_roundkettle_over_imperial_leather
Roundkettle Over Imperial Cloth = roundkettle_over_imperial_cloth
Spiked Kettle Over Imperial Padding = spiked_kettle_over_imperial_padding
Imperial Open Mail Coif = imperial_open_mail_coif
Mail Coif = mail_coif
Open Mail Coif = open_mail_coif
Iron Roundkettle Over Imperial Leather = ironlame_roundkettle_over_imperial_leather
Empire crown = empire_crown
Heavy Nasalhelm Over Imperial Mail = heavy_nasalhelm_over_imperial_mail
Bronze Nasalhelm Over Imperial Mail = leatherlame_nasalhelm_over_imperial_mail
Iron Nasalhelm Over Imperial Mail = ironlame_nasalhelm_over_imperial_mail
Iron Feathered Spangenhelm = ironlame_feathered_spangenhelm
Feathered Spangenhelm Over Imperial Coif = feathered_spangenhelm_over_imperial_coif
Bronze Feathered Spangenhelm Over Mail = leatherlame_feathered_spangenhelm_over_mail
Roundkettle Over Imperial Mail = roundkettle_over_imperial_mail
Helmet With Faceguard = helmet_with_faceguard
Heavy Nasalhelm Over Imperial Padding = heavy_nasalhelm_over_imperial_padding
Heavy Nasalhelm Over Laced Cloth = heavy_nasalhelm_over_laced_cloth
Heavy Nasalhelm Over Imperial Leather = heavy_nasalhelm_over_imperial_leather
Iron Feathered Spangenhelm Over Leather = ironlame_feathered_spangenhelm_over_leather
Bronze Roundkettle Over Imperial Mail = leatherlame_roundkettle_over_imperial_mail
Iron Roundkettle Over Imperial Mail = ironlame_roundkettle_over_imperial_mail
Spiked Kettle Over Imperial Mail = spiked_kettle_over_imperial_mail
Iron Spiked Kettle Over Mail = ironlame_spiked_kettle_over_mail
Imperial Lord Helmet = empire_lord_helmet
Imperial Guarded Lord Helmet = empire_guarded_lord_helmet
Imperial Jewelled Helmet = empire_jewelled_helmet
Imperial Helmet with Metal Strips = empire_helmet_with_metal_strips
Iron Nasalhelm Over Imperial Padding = ironlame_nasalhelm_over_imperial_padding
Iron Nasalhelm Over Imperial Cloth = ironlame_nasalhelm_over_imperial_cloth
Plumed Helmet = Item id="plumed_helmet
Imperial Long Cape = pauldron_cape_a
Imperial Padded Shoulders = empire_warrior_padded_armor_shoulder
Woven Leather Shoulders = woven_leather_shoulders
Imperial Studded Strip Shoulders = imperial_studded_strip_shoulders
Studded Imperial Neckguard = studded_imperial_neckguard
Commoner Clothes = peasant_costume
Rich Tunic = fine_town_tunic
Hemp Tunic = hemp_tunic
Tied Cloth Tunic = tied_cloth_tunic
Imperial Rich Dress = vlandian_dress
Ladies Dress = empire_dress
Red Dress = empire_dress_b
Military Tunic = footmans_tunic
Tunic With Rolled Cloth = tunic_with_rolled_cloth
Imperial Robes = imperial_robes
Padded Cloth With Strips = padded_cloth_with_strips
Leather Tunic = leather_tunic
Patched Gambeson = patched_gambeson
Imperial Padded Cloth = imperial_padded_cloth
Imperial Stitched Leather = khuzait_leather_stitched
Imperial Gambeson = empire_warrior_padded_armor_a
Imperial Gambeson With Skirts = empire_warrior_padded_armor_c
Imperial Gambeson With Straps = empire_warrior_padded_armor_d
Imperial Long Gambeson = empire_warrior_padded_armor_e
Imperial Auxiliary Armor = empire_warrior_padded_armor_f
Imperial Auxiliary Armor With Straps = empire_warrior_padded_armor_g
Imperial Studded Leather = eastern_studded_leather
Imperial Simple Leather Armor = basic_imperial_leather_armor
Woven Leather Coat = woven_leather_coat
Imperial Gambeson Over Leather Jacket = empire_warrior_padded_armor_b
Imperial Mail Over Stripped Leather = imperial_mail_over_stripped_leather
Imperial Cavalry Armor = empire_horseman_armor
Imperial Mail Over Leather = imperial_mail_over_leather
Imperial Mail Vest = imperial_mail_vest
Imperial Scale Armor = imperial_scale_armor
Imperial Lamellar Over Leather = imperial_lamellar_over_leather
Lamellar With Scale Skirt = lamellar_with_scale_skirt
Legionary Mail = legionary_mail
Imperial Lamellar = imperial_lamellar
Woven Leather Bracers = woven_leather_bracers
Plated Striped Gauntlets = plated_strip_gauntlets
Lamellar Plate Gauntlets = lamellar_plate_gauntlets
Decorated Imperial Gauntlets = decorated_imperial_gauntlets
Lordly Padded Mittens = lordly_padded_mitten
Reinforced Padded Mittens = reinforced_padded_mitten
Lady's Shoes = ladys_shoe
Fine Town Boots = fine_town_boots
Folded Town Boots = folded_town_boots
Leather Shoes = leather_shoes
Imperial Horseman Boots = empire_horseman_boots
Splint Boots = plated_strip_boots
Decorated Imperial Boots = decorated_imperial_boots
Lamellar Plate Boots = lamellar_plate_boots
Rough Padded Cap = vlandia_bandit_cape_a
Hide Cap = vlandia_bandit_cape_b
Dummy Min Armor = dummy_armor_min
Dummy Lower Average = dummy_armor_lower_average
Dummy Higher Average = dummy_armor_higher_average
Dummy Max Armor = dummy_armor_max
Burlap Dress = burlap_sack_dress
Commoners Shirt = bandit_leather_water_flask
Torn Padded Garments = torn_bandit_clothes
Commoners Tunic = bandit_envelope_dress_v1
Sleeveless Enveloped Padded Garments = bandit_envelope_dress_v2
Old Fur Armor = bandit_fur_a
Old Fur Coat = bandit_fur_b
Empire Short Tunic = empire_short_dress
Fur Skirt = fur_skirt
Fur Skirt With Tunic = fur_skirt_with_tunic
Fur Waistcoat Over Tunic = fur_waistcoat_over_tunic
Sleeveless Fur Coat = sleeveless_fur_coat
Fur Coat Over Tunic = fur_coat_over_tunic
Rugged Gambeson = bandit_gambeson
Rough Fur Armor = rough_fur_armor
Padded Leather Overcoa = padded_leather_overcoat
Cheap Paddings = vlandia_bandit_a
Cheap Colored Clothes = vlandia_bandit_b
Torn Robe = vlandia_bandit_c
Rough Fur Over Chain = rough_fur_over_chain
Buckled Wildsman Armor = buckled_wildsman_armor
Merchant's Hat = merchants_hat
Cloth Apron = cloth_apron
Half Apron = half_apron
Merchant's Fur Coat = merchants_fur_coat
Torch = torch
Sledgehammer = peasant_maul_t1
Pickaxe = peasant_pickaxe_1_t1
Hatchet = peasant_hatchet_1_t1
Sickle = peasant_sickle_1_t1
Blacksmith Hammer = peasant_hammer_1_t1
Wooden Hammer = peasant_hammer_2_t1
Hoe = peasant_2haxe_1_t1
Iron Pitchfork = peasant_pitchfork_1_t1
Pitchfork = peasant_pitchfork_2_t1
Scythe = peasant_polearm_1_t1
Practice Bow = training_bow
Practice Longbow = training_longbow
Wooden Sword = wooden_sword_t1
Practice Spear = practice_spear_t1
Push Fork = push_fork
Winds Fury = winds_fury_sword_t3
The Scalpel = the_scalpel_sword_t3
Dawnbreaker = dawnbreaker_sword_t3
The Ambassador = ambassador_sword_t3
Bone Crusher = bone_crusher_mace_t3
Pernach = pernach_mace_t3
Knight's Fall = knights_fall_mace_t3
Judgement = judgement_mace_t3
Black Heart = black_heart_2haxe_t3
Wood Splitter Axe = aserai_axe_1_t2
Bamboo Handled Ascia Axe = aserai_axe_2_t2
Gallogaich Axe = sturgia_axe_2_t2
Norse Hatchet = battania_axe_1_t2
Small Spurred Axe = small_spurred_axe_t2
Southern Small Axe = southern_small_axe_t2
Small Bit Axe = small_bit_axe_t2
Northern Simple Battle Axe = northern_battle_axe_t3
Western Infantry Axe = vlandia_axe_1_t3
Northern Common Axe = sturgia_axe_3_t3
Imperial axe = imperial_axe_t3
Woodland axe = woodland_axe_t3
Tzkurion Axe = tzkurion_axe_t3
Large Franziska Axe = large_franziskaa_axe_t3
Northern Spiked Battle Axe = vlandia_axe_2_t4
Veteran Warriors Axe = sturgia_axe_4_t4
One Handed Bearded Axe = battania_axe_2_t4
Bamboo Axe = bamboo_axe_t4
Battle Axe = battle_axe_t4
Northern Rectangular Bitted Axe = sturgia_axe_5_t5
Round Bitted Fine Steel Hatchet = battania_axe_3_t5
Square Bit Two Handed Axe = battania_2haxe_1_t2
Simple Sparth Axe = simple_sparth_axe_t2
Southern Broad Two Handed Axe = aserai_2haxe_1_t3
Bearded Axe = bearded_axe_t3
Short Bill = vlandia_2haxe_1_t4
Executioners Axe = aserai_2haxe_2_t4
Drilled Two Handed Axe = sturgia_2haxe_1_t4
Hooked Western Axe = hooked_axe_t4
Heavy Executioners Axe = aserai_2haxe_3_t5
Northern Decorated Two Handed Axe = sturgia_2haxe_2_t5
Western Simple Spear = western_spear_1_t2
Western Short Spear = western_spear_2_t2
Jagged Spear = eastern_spear_1_t2
Northern Short Simple Spear = northern_spear_1_t2
Imperial Spear = imperial_spear_t2
Military Fork = military_fork_t2
Western Long Spear = western_spear_3_t3
Narrow Long Headed Eastern Spear = eastern_spear_2_t3
Weighted Eastern Spear = eastern_spear_3_t3
Broad Leaf Shaped Spear = northern_spear_2_t3
Jagged Throwing Spear = eastern_throwing_spear_1_t3
Triangular Headed Spear = triangluar_spear_t3
Long Fine Steel Spear = western_spear_4_t4
Fine Steel Leaf Spear = eastern_spear_4_t4
Jagged Fine Steel Spear = northern_spear_3_t4
Triangular Throwing Spear = eastern_throwing_spear_2_t4
Pila = imperial_throwing_spear_1_t4
Wide Leaf Spear = wide_leaf_spear_t4
Thin Fine Steel Hewing Spear = eastern_spear_5_t5
Fine Steel Hewing Spear = northern_spear_4_t5
Simple Pike = simple_pike_t2
Notched Military Fork = military_fork_pike_t3
Thamaskene Pike = thamaskene_pike_t4
Western Pike = vlandia_pike_1_t5
Billhook = billhook_polearm_t2
Warrazor = sturgia_polearm_1_t5
Menavlion = empire_polearm_1_t4
Glaive = khuzait_polearm_1_t4
Eastern Polesword = easter_polesword_t4
Rhomphalia = battania_polearm_1_t5
Voulge = vlandia_polearm_1_t5
Fine Steel Menavlion = empire_polearm_2_t5
Long Glaive = khuzait_polearm_2_t5
Vlandian Light Lance = vlandia_lance_1_t3
Imperial Light Lance = empire_lance_1_t3
Khuzait Light Lance = khuzait_lance_1_t3
Mamluke Lance = aserai_lance_1_t5
Vlandia Lance = vlandia_lance_2_t4
Imperial Lance = empire_lance_2_t4
Sturgian Lance = sturgia_lance_1_t4
Khuzait Lance = khuzait_lance_2_t4
Vlandian Heavy Lance = vlandia_lance_3_t5
Sturgian Heavy Lance = sturgia_lance_2_t5
Cataphract Lance = empire_lance_3_t5
Eastern Noble Lance = khuzait_lance_3_t5
Iron Arming Sword = vlandia_sword_1_t2
Iron Spatha = empire_sword_1_t2
Iron Flyssa = aserai_sword_1_t2
Iron Scimitar = aserai_sword_2_t2
Iron Sabre = khuzait_sword_1_t2
Tapered Northern Blade = sturgia_sword_1_t2
Ridged Iron Broadsword = battania_sword_1_t2
Simple Sabre = simple_sabre_sword_t2
Simple Eastern Backsword = simple_back_sword_t2
Ridged Tipped Arming Sword = vlandia_sword_2_t3
Spatha With Narrow Fuller = empire_sword_2_t3
Spatha = empire_sword_3_t3
Slightly Ridged Flyssa = aserai_sword_3_t3
Northern Backsword = sturgia_sword_2_t3
Pointy Warsword = sturgia_sword_3_t3
Broad Ridged Shortsword = battania_sword_2_t3
Star Falchion = star_falchion_sword_t3
Broad Falchion = broad_falchion_sword_t3
Broad Ild = broad_ild_sword_t3
Short Sword = short_sword_t3
Narrow Sword = narrow_sword_t3
Cleaver = cleaver_sword_t3
Knightly Arming Sword = vlandia_sword_3_t4
Ridged Arming Sword = vlandia_sword_4_t4
Fine Steel Spatha = empire_sword_4_t4
Fine Steel Paramerion = empire_sword_5_t4
Fine Steel Long Kaskara = aserai_sword_4_t4
Ridged Arming Sword = vlandia_sword_4_t4
Fine Steel Long Kaskara = aserai_sword_4_t4
Long Fine Steel Scimitar = aserai_sword_5_t4
Narrow Fine Steel Kaskara = aserai_sword_6_t4
Heavy Sabre = khuzait_sword_5_t4
Long Warsword = sturgia_sword_4_t4
Fullered Narrow Warsword = sturgia_sword_5_t4
Fine Steel Cavalry Broadsword = battania_sword_4_t4
Pointed Falchion = pointed_falchion_sword_t4
Ridged Sabre = ridged_sabre_sword_t4
Broad Arming Sword = broad_arming_sword_t4
Desert Long Sword = desert_long_sword_t4
Wide Fullered Broad Arming Sword = vlandia_sword_5_t5
Thamaskene Steel Spathion = empire_sword_6_t5
Thamaskene Steel Kaskara = aserai_sword_7_t5
Fullered Long Warsword = sturgia_sword_5_t5
Highland Broad Blade = battania_sword_5_t5
Arming Sword With Golden Petals Imprint = vlandia_noble_sword_1_t5
Arming Sword With Golden Circle Imprint = vlandia_noble_sword_2_t5
Decorated Short Spatha = empire_noble_sword_1_t5
Thamaskene Steel Spatha = empire_noble_sword_2_t5
Decorated Kaskara = aserai_noble_sword_1_t5
Decorated Long Scimitar = aserai_noble_sword_2_t5
Decorated Sabre = khuzait_noble_sword_1_t5
Lion Imprinted Sabre = khuzait_noble_sword_2_t5
Thamaskene Steel Warsword = sturgia_noble_sword_1_t5
Decorated Long Warsword = sturgia_noble_sword_2_t5
Engraved Backsword = battania_noble_sword_1_t5
Highland Fine Steel Blade = battania_noble_sword_2_t5
Iron Broadsword = battania_2hsword_1_t2
Simple Bastard Sword = bastard_sword_t2
Highland Broadsword = battania_2hsword_2_t3
Wide Fullered Northern Greatsword = battania_2hsword_3_t3
Two Handed Cleaver = cleaver_2hsword_t3
Tapered Two Hander = western_2hsword_t3
Ridged Long Kaskara = kaskara_2hsword_t3
Falx = battania_2hsword_4_t4
Fine Steel Two Handed Sword = northern_2hsword_t4
Broad Two Hander = western_2hsword_t4
Ridged Great Sabre = ridged_2hsword_t4
TwoHandedSword = war_razor_2hsword_t4
Southern Broad Kaskara = southern_broad_2hsword_t4
Battanian Mountain Blade = battania_2hsword_5_t5
Wide Fullered Broad Two Hander = vlandia_2hsword_1_t5
Thamaskene Steel Two Hander = vlandia_2hsword_1_t5
Seax = seax
Highland Dagger = celtic_dagger
Pugio = pugio
Falx Knife = hooked_cleaver
Xiphos = gladius_b
Spiked Mace = vlandia_mace_1_t2
Spiked Club = empire_mace_1_t2
Southern Militia Mace = aserai_mace_1_t2
Southern Light Mace = aserai_mace_2_t2
Knobbed Club = battania_mace_1_t2
Highland Spiked Club = battania_mace_2_t2
Southern Heavy Mace = aserai_mace_3_t3
Steel Shestopyor = steel_mace_t3
Morningstar = morningstar_mace_t3
Fullered Western Mace = vlandia_mace_2_t4
Imperial Light Mace = empire_mace_2_t4
Calradic Mace = empire_mace_3_t4
Spiralled Mace = aserai_mace_4_t4
Eastern Heavy Mace = khuzait_mace_2_t4
Light Shishpar Mace = shishpar_mace_t4
Pernach = vlandia_mace_3_t5
Light Royal Mace = empire_mace_4_t5
Cataphracts Mace = empire_mace_5_t5
Eastern Flanged Mace = khuzait_mace_4_t5
Hunting Bow = hunting_bow
Mountain Hunting Bow = mountain_hunting_bow
Steppe Bow = steppe_bow
Longbow = glen_ranger_bow
Ranger Bow = highland_ranger_bow
Simple Short Bow = composite_bow
Steppe Recurve Bow = composite_steppe_bow
Heavy Recurve Bow = steppe_heavy_bow
Nordic Shortbow = nordic_shortbow
Western Longbow = lowland_longbow
Southern Tribesman's Bow = tribal_bow
Steppe War Bow = steppe_war_bow
Woodland Yew Bow = woodland_yew_bow
Woodland Longbow = woodland_longbow
Southern Strong Longbow = longbow_recurve_desert_bow
Nomad Bow = nomad_bow
Western Yew Bow = lowland_yew_bow
Noble Bow = noble_bow
Noble Long Bow = noble_long_bow
Light Crossbow = crossbow_a
Heavy Crossbow = crossbow_b
Arbalest = crossbow_c
Crossbow = crossbow_e
Hickory Crossbow = crossbow_d
Fine Crossbow = crossbow_g
Bound Crossbow = crossbow_f
Simple Javelin = western_javelin_1_t2
Fish Harpoon = northern_javelin_1_t2
Eastern Jagged Javelin = eastern_javelin_1_t2
Western Javelin = western_javelin_2_t3
Harpoon = generic_javelin_1_t3
Eastern Javelin = eastern_javelin_2_t3
Hooked Javelin = western_javelin_3_t4
Broad Blade Javelin = northern_javelin_3_t4
Jereed = eastern_javelin_3_t4
Highland Throwing Axe = highland_throwing_axe_1_t2
Southern Throwing Axe = southern_throwing_axe_1_t4
Highland Throwing Axe = woodland_throwing_axe_1_t1
Franceska = western_throwing_axe_1_t1"
Western Throwing Knife = lowland_throwing_knife
Southern Throwing Daggers = desert_throwing_knife
Highland Throwing Dagger = celtic_throwing_dagger
Imperial Broad Bladed Throwing Knives = empire_throwingknife_t5
Stone = throwing_stone
Ballista Arrows = ballista_projectile
Ballista Arrows = ballista_projectile_burning
Boulder = boulder
Fire Pot = pot
Western Arrows = vlandic_arrows
Imperial Arrows = arrow_emp_1_a
Piercing Arrows = piercing_arrows
Stacked Bodkin Arrows = bodkin_arrows_a
Bodkin Arrows = bodkin_arrows_b
Light Bodkin Arrows = bodkin_arrows_c
Steppe Arrows = steppe_arrows
Stacked Steppe Arrows = heavy_steppe_arrows
Barbed Arrows = barbed_arrows
Range Arrows = range_arrows
Tournament Arrows = tournament_arrows
Arrows = default_arrows
Tournament Bolts = tournament_bolts
Bolt = bolt_a
Bolt = bolt_b
Bolt = bolt_c
Bolt = bolt_d
Bolt = bolt_e
Blunt Arrows = blunt_arrows
Blunt Bolts = blunt_bolts
Heavy Round Shield = heavy_round_shield
Large Round Shield = leather_round_shield
Reinforced Large Round Shield = strapped_round_shield
Heavy Oval Shield = heavy_oval_shield
Wooden Oval Shield = oval_shield
Reinforced Southern Round Shield = desert_round_shield
Southern Round Shield = bound_desert_round_shield
Southern Round Sparring Shield = bound_desert_round_sparring_shield
Curved Round Shield = curved_round_shield
Iron Round Shield = studded_round_shield
Steel Round Shield = steel_round_shield
Wooden Adarga = bound_adarga
Large Adarga = large_adarga
Makeshift Kite Shield = old_kite_shield
Makeshift Kite Sparring Shield = old_kite_sparring_shield
Worn Kite Shield = worn_kite_shield
Leather Bound Kite Shield = leather_bound_kite_shield
Reinforced Kite Shield = reinforced_kite_shield
Reinforced Oaken Kite Shield = stronger_reinforced_kite_shield
Pavise Shield = pavise_shield
Wooden Kite Shield = old_horsemans_kite_shield
Makeshift Horsemans Kite Shield = worn_horsemans_kite_shield
Cavalry Kite Shield = bound_horsemans_kite_shield
Reinforced Cavalry Small Shield = reinforced_horsemans_kite_shield
Battered Horseman's Kite Shield = battered_horsemans_kite_shield
Light Cavalry Kite Shield = light_horsemans_kite_shield
Reinforced Cavalry Kite Shield = heavy_horsemans_kite_shield
Battered Kite Shield = battered_kite_shield
Reinforced Flat Kite Shield = reinforced_flat_kite_shield
Studded Bound Kite Shield = studded_bound_kite_shield
Fortified Kite Shield = fortified_kite_shield
Bound Heater Shield = bound_heater_shield
Small Cavalry Heater Shield = horsemans_heater_shield
Small Heater Shield = small_heater_shield
Knights Shield = jousting_shield
Heater Shield With Cutout = heater_shield_with_cutout
Flat Heater Shield = flat_heater_shield
Heavy Heater Shield = heavy_heater_shield
Small Flat Heater Shield = small_flat_heater_shield
Wide Heater Shield = wide_heater_shield
Bracketed Heater Shield = bracketed_heater_shield
Tall Heater Shield = tall_heater_shield
Adarga = adarga
Studded Adarga = studded_adarga
Ornate Adarga = ornate_adarga
Desert Oval Shield = desert_oval_shield
Reinforced Oval Shield = southern_oval_shield
Decorated Oval Shield = emirs_oval_shield
Decorated Round Shield = highland_scouts_shield
Highland Round Shield = highland_riders_shield
Tribal Steppe Shield = tribal_steppe_shield
Round Steppe Shield = decorated_steppe_shield
Decorated Eastern Shield = noyans_shield
Eastern Cavalry Shield = steppe_guardian_shield
Wicker Square Shield = eastern_wicker_shield
Wicker Square Tournament Shield = eastern_wicker_sparring_shield
Reinforced Wicker Square Shield = stronger_eastern_wicker_shield
Wicker Shield = footmans_wicker_shield
Reinforced Wicker Shield = stronger_footmans_wicker_shield
Northern Cavalry Kite Shield = northern_scouts_shield
Reinforced Cavalry Shield = northern_horsemans_shield
Norse Round Shield = viking_round_shield
Northern Round Shield = northern_round_shield
Northern Round Sparring Shield = northern_round_sparring_shield
Western Riders Kite Shield = western_riders_kite_shield
Western Riders Kite Sparring Shield = western_riders_kite_sparring_shield
Reinforced Ironrimmed Kite Shield = ironrim_riders_kite_shield
Knights Kite Shield = chivalric_kite_shield
Kite Shield = western_kite_shield
Kite Sparring Shield = western_kite_sparring_shield
Ironrimed Kite Shield = ironrim_kite_shield
Desert Horse = aserai_horse_tournament
Battanian Pony = battania_horse_tournament
Midlands Palfrey = empire_horse_tournament
Steppe Horse = khuzait_horse_tournament
Sturgian Trotter = sturgia_horse_tournament
Saddle Horse = vlandia_horse_tournament
Camel = camel_tournament
Sumpter Horse = sumpter_horse
Old Work Horse = old_horse
Mule = mule
Pack Camel = pack_camel
Pack Camel = pack_camel_unmountable
Desert Horse = aserai_horse
Battanian Pony = battania_horse
Midlands Palfrey = empire_horse
Steppe Horse = khuzait_horse
Sturgian Trotter = sturgia_horse
Saddle Horse = vlandia_horse
Camel = camel
Aserai Horse = t2_aserai_horse
Battanian Warmount = t2_battania_horse
Imperial Charger = t2_empire_horse
Steppe Warhorse = t2_khuzait_horse
Sturgian Hunter = t2_sturgia_horse
Vlandian Courser = t2_vlandia_horse
War Camel = war_camel
Charger = charger
Nahasawi = noble_horse_southern
Cossian = noble_horse_imperial
Asaligat = noble_horse_eastern
Tyal Horse = noble_horse_northern
Destrier = noble_horse_western
Husnphree = special_camel
Pureblood = noble_horse
Storm Charger = storm_charger
War Horse = war_horse
Steppe War Horse = steppe_war_horse
Desert War Horse = desert_war_horse
Rugged Desert Saddle = bandit_saddle_desert
Halfchain Barding = halfchain_barding
Chain Horse Harness = chain_horse_harness
Striped Leather Harness = stripped_leather_harness
Imperial Riding Harness = imperial_riding_harness
Imperial Scale Barding = imperial_scale_barding
Studded Steppe Barding = studded_steppe_barding
Desert Cloth Harness = desert_cloth_harness
Southern Common Harness = aseran_village_harness
Half Mail And Plate Barding = half_mail_and_plate_barding
Mail And Plate Barding = mail_and_plate_barding
Steppe Harness = steppe_harness
Steppe Fur Harness = steppe_fur_harness
Steppe Half Barding = steppe_half_barding
Studded Steppe Bardin = studded_steppe_barding
Northern Ring Barding = northern_ring_barding
Battania Horse Harness = battania_horse_harness
Mule Harness with Pack = mule_load_a
Mule Harness with Bags = mule_load_c
Camel Saddle = camel_saddle
Camel Saddle with Heavy Load = camel_saddle_a
Camel Saddle with Light Load = camel_saddle_b
Wool = wool
Silver Ore = silver
Jewelry = jewelry
Salt = salt
Spice = spice
Cotton = cotton
Flax = flax
Clay = clay
Pottery = pottery
Linen = linen
Leather = leather
Velvet = velvet
Cheese = cheese
Butter = butter
Fish = fish
Grapes = grape
Dates = date_fruit
Olives = olives
Beer = beer
Wine = wine
Oil = oil
Fur = fur
Stolen Goods = stolen_goods
Triangle Banner = banner_mid
Big Banner = banner_big
Campaign Banner Small = campaign_banner_small
Bo staff = bo_staff
Hare = hare
Cat = cat
Dog = dog
Sheep =sheep
Cow = cow
Hog = hog
Goose = goose
Chicken = chicken
